########
#O PX  #
#      #
# O X  #
#      #
########
